########################
# # # ##  #  #   ##    #
#    #      ###   #   ##
#  #      #     #      #
## ##  #  ###  ###  ## #
#   ##  #       #  # # #
##  #  ##     #      # #
#1         # ####    # #
###     #   #  ##  #####
#    #     #          2#
########################