###########
# # # ##  #
#    #   ##
#  #      #
## ##  ####
#   ##  # #
##  #  ## #
#         #
####### # #
#         #
###########